0000000000000000000000000044000000000000000000000000
0000000000000000000000000022000000000000000000000000
0000000000000000000000000000000000002000000000000000
0000000000000000000000000000000000001220000000000000
0000000000000000000000000000000000000000000000000000
0000000000000000000000000000000000000000000000000000
0000000000000000000000000000000000000000000000000000
0000000000000000000000000000000000000000000000000000
0000000000300000000000000000000000000000000000000000
0000000222220000000000000000000000000000000300000000
0000000000000000000000000000000000000000000222000000
2200300300003000000000030220000000030000000000000000
1122222222222000030000022112000022222000000000000000
1111111111111222222000011111000001110000000000000000
1111111111111111111000001100000000010000000000000000
1111111111111111111000001000000000010000000000000000
1111111111111111111000001000000000000000000000000000
1111111111111111111000000000000000000000000000000000
0000000000000000000000000000000000000000000000000000